11111111
10000001
100W0001
10000001
11111111